............
....A.......
.....A......
......A.....
.......A....
............