.............
.0..0........
..0..0.......
...0..0......
....0..0.....
.....0..0....
......0......
......0......
.......A.....
........A....
.........A...
.............
